1111111111111111111111111111111111
1E0000000000000C000e0C0000000000C1
10100101001000001010010e0000010101
1010e1001010101e001001000e00010101
1P00000e0C00C00000000000000C0000C1
1111111111111111111111111111111111
