11111111111111111
1C000000C00000001
1000000001000e001
100P00C001000e001
1e000000010C00001
1000C000010001001
10e0000000E000e01
11111111111111111
