11111111111111111
1C000000C00000001
10100C0100101e001
1000CPC000000e001
1000eC00000C00001
1000000C000e01001
10e0100000E100e01
11111111111111111
