11111111111111111
1P0000C0111111111
11C00011111111111
10C00011111111111
1100100E111111111
11111111111111111