1111111111
110C000011
10010e0E11
1111111111