111111111111111
100000e0000C001
100C0000P0e0001
11e1110e0001111
1E00000C0011111
111111111111111
